....................
....................
....................
....................
....................
....................
....................
...........CCC......
.......B...###......
....................
......###.......CCC.
................###.
.###................
....................
####################
